Graph Size: 20
MAZE: 
+ +-+-+-+-+-+-+-+-+-+-+-+-+-+-+-+-+-+-+-+
|       |     |             |   |   |   |
+-+-+-+ +-+ + +-+ +-+ +-+-+ +-+ + + + + +
|     | |   |   | |   |   |     | |   | |
+ +-+-+ + +-+-+ + + +-+ + +-+-+-+ +-+-+ +
| |     | | |   | |   | |         |   | |
+ + +-+-+ + + +-+-+-+ + +-+-+-+-+-+ + + +
| |       |   |     | |             | | |
+ +-+-+-+-+ +-+ +-+ + +-+-+-+-+-+-+-+ + +
| |       |     | | |         |     | | |
+ + +-+-+ +-+-+-+ + +-+ + +-+ + +-+ + + +
| |   |   |       |   | |   | | | | | | |
+ + +-+ +-+ + +-+-+-+ + +-+ +-+ + + + + +
| | |   |   |       | | |   |     |   | |
+ + + +-+ +-+-+-+-+ + + + +-+ +-+-+-+-+ +
| | | |   | |     |   | | |   |         |
+ + + + +-+ + +-+ +-+-+-+ + +-+ +-+-+-+ +
|   |   |     |   |       | |   |       |
+ +-+-+-+-+-+-+ + + + +-+-+ + + +-+-+-+ +
| |             | | |       | | |     | |
+ +-+-+ +-+-+-+-+ + +-+-+ +-+ +-+ +-+ + +
|   |   |       | | |   |   |   |   | | |
+-+ + +-+ +-+ + + +-+ + +-+-+-+ +-+ + +-+
| |   |   |   | | |   |       | |   |   |
+ +-+-+ +-+ +-+ + + +-+-+-+-+ + + +-+-+ +
|     | | | |   | |     |   | | |   |   |
+-+ +-+ + + + +-+ +-+-+ + + + + +-+ + +-+
|   |     | |   |       | |   | |   |   |
+ + + +-+-+ +-+ +-+-+-+-+ +-+-+ + +-+-+ +
| | |   |   |     |     |     |       | |
+ +-+-+ + +-+-+-+-+ +-+ +-+-+ +-+-+-+ + +
|     | |         |   |     | |     | | |
+ + +-+ +-+-+-+-+ +-+ + +-+-+ + +-+ +-+ +
| |     | |     |   | |       |   | |   |
+ +-+-+-+ + +-+ + + + +-+-+-+-+-+ + + +-+
|     |   |   |   | | |     |     | |   |
+-+-+ +-+ +-+ +-+-+ + +-+ + + + +-+ +-+ +
|   |   |   | |   | |   | | | | | | |   |
+ +-+-+ + + + + + +-+-+ + + +-+ + + + + +
|         | |   |         |     |     | |
+-+-+-+-+-+-+-+-+-+-+-+-+-+-+-+-+-+-+-+ +

BFS: 
+ +-+-+-+-+-+-+-+-+-+-+-+-+-+-+-+-+-+-+-+
|# # # #|# # #|             |   |   |   |
+-+-+-+ +-+ + +-+ +-+ +-+-+ +-+ + + + + +
|# # #|#|# #|# #| |   |   |     | |   | |
+ +-+-+ + +-+-+ + + +-+ + +-+-+-+ +-+-+ +
|#|# # #|#|#|# #| |   | |         |   | |
+ + +-+-+ + + +-+-+-+ + +-+-+-+-+-+ + + +
|#|# # # #|# #|# # #| |             | | |
+ +-+-+-+-+ +-+ +-+ + +-+-+-+-+-+-+-+ + +
|#|# # # #|# # #|#|#|         |     | | |
+ + +-+-+ +-+-+-+ + +-+ + +-+ + +-+ + + +
|#|# #|# #|# # # #|# #| |   | | | | | | |
+ + +-+ +-+ + +-+-+-+ + +-+ +-+ + + + + +
|#|#|# #|# #|# # # #|#| |   |     |   | |
+ + + +-+ +-+-+-+-+ + + + +-+ +-+-+-+-+ +
|#|#|#|# #|#|# # #|# #| | |   |         |
+ + + + +-+ + +-+ +-+-+-+ + +-+ +-+-+-+ +
|# #|# #|# # #|# #|       | |   |       |
+ +-+-+-+-+-+-+ + + + +-+-+ + + +-+-+-+ +
|#|# # # # # # #|#| |       | | |     | |
+ +-+-+ +-+-+-+-+ + +-+-+ +-+ +-+ +-+ + +
|# #|# #|       |#| |# #|   |   |   | | |
+-+ + +-+ +-+ + + +-+ + +-+-+-+ +-+ + +-+
| |# #|   |   | |#|# #|# # # #| |   |   |
+ +-+-+ +-+ +-+ + + +-+-+-+-+ + + +-+-+ +
|     | | | |   |#|# # #|# #|#| |   |   |
+-+ +-+ + + + +-+ +-+-+ + + + + +-+ + +-+
|   |     | |   |# # # #|#|# #| |   |   |
+ + + +-+-+ +-+ +-+-+-+-+ +-+-+ + +-+-+ +
| | |   |# #|     |# # #|# # #|       | |
+ +-+-+ + +-+-+-+-+ +-+ +-+-+ +-+-+-+ + +
|     | |# # # # #|# #|# # #|#|# # #| | |
+ + +-+ +-+-+-+-+ +-+ + +-+-+ + +-+ +-+ +
| |     | |# # #|# #|#|# # # #|# #|#|   |
+ +-+-+-+ + +-+ + + + +-+-+-+-+-+ + + +-+
|     |   |# #|# #|#|#|# # #|# # #|#|  #|
+-+-+ +-+ +-+ +-+-+ + +-+ + + + +-+ +-+ +
|   |   |   |#|# #|#|# #|#|#|#|#|#|#|# #|
+ +-+-+ + + + + + +-+-+ + + +-+ + + + + +
|         | |# #|# # # # #|# # #|# # #|#|
+-+-+-+-+-+-+-+-+-+-+-+-+-+-+-+-+-+-+-+ +

+ +-+-+-+-+-+-+-+-+-+-+-+-+-+-+-+-+-+-+-+
|0 1 2 3|6 5 7|             |   |   |   |
+-+-+-+ +-+ + +-+ +-+ +-+-+ +-+ + + + + +
|0 2 5|4|3 4|8 9| |   |   |     | |   | |
+ +-+-+ + +-+-+ + + +-+ + +-+-+-+ +-+-+ +
|8|7 6 5|2|5|1 0| |   | |         |   | |
+ + +-+-+ + + +-+-+-+ + +-+-+-+-+-+ + + +
|6|8 9 0 1|3 2|8 9 0| |             | | |
+ +-+-+-+-+ +-+ +-+ + +-+-+-+-+-+-+-+ + +
|4|0 9 8 7|4 6 7|6|1|         |     | | |
+ + +-+-+ +-+-+-+ + +-+ + +-+ + +-+ + + +
|2|1 3|5 6|3 1 2 4|2 3| |   | | | | | | |
+ + +-+ +-+ + +-+-+-+ + +-+ +-+ + + + + +
|0|2|3 4|7 5|0 9 8 7|4| |   |     |   | |
+ + + +-+ +-+-+-+-+ + + + +-+ +-+-+-+-+ +
|8|4|2|9 8|2|6 4 2|6 5| | |   |         |
+ + + + +-+ + +-+ +-+-+-+ + +-+ +-+-+-+ +
|6 5|1 0|3 0 8|0 1|       | |   |       |
+ +-+-+-+-+-+-+ + + + +-+-+ + + +-+-+-+ +
|7|7 4 1 3 6 8 9|3| |       | | |     | |
+ +-+-+ +-+-+-+-+ + +-+-+ +-+ +-+ +-+ + +
|9 1|7 9|       |5| |2 3|   |   |   | | |
+-+ + +-+ +-+ + + +-+ + +-+-+-+ +-+ + +-+
| |3 5|   |   | |7|0 1|4 5 6 7| |   |   |
+ +-+-+ +-+ +-+ + + +-+-+-+-+ + + +-+-+ +
|     | | | |   |9|9 8 7|2 1|8| |   |   |
+-+ +-+ + + + +-+ +-+-+ + + + + +-+ + +-+
|   |     | |   |1 4 5 6|3|0 9| |   |   |
+ + + +-+-+ +-+ +-+-+-+-+ +-+-+ + +-+-+ +
| | |   |6 8|     |7 6 4|4 5 6|       | |
+ +-+-+ + +-+-+-+-+ +-+ +-+-+ +-+-+-+ + +
|     | |3 0 7 4 1|8 9|2 3 5|7|4 6 8| | |
+ + +-+ +-+-+-+-+ +-+ + +-+-+ + +-+ +-+ +
| |     | |8 1 3|9 2|0|1 0 9 8|2 0|0|   |
+ +-+-+-+ + +-+ + + + +-+-+-+-+-+ + + +-+
|     |   |5 3|5 7|5|1|1 9 2|6 4 7|3|  9|
+-+-+ +-+ +-+ +-+-+ + +-+ + + + +-+ +-+ +
|   |   |   |1|5 3|8|2 3|7|4|9|2|4|6|5 7|
+ +-+-+ + + + + + +-+-+ + + +-+ + + + + +
|         | |9 7|0 8 6 4 5|6 8 0|1 9 2|0|
+-+-+-+-+-+-+-+-+-+-+-+-+-+-+-+-+-+-+-+ +

DFS: 
+ +-+-+-+-+-+-+-+-+-+-+-+-+-+-+-+-+-+-+-+
|# # # #|  # #|             |   |   |   |
+-+-+-+ +-+ + +-+ +-+ +-+-+ +-+ + + + + +
|     |#|# #|# #| |   |   |     | |   | |
+ +-+-+ + +-+-+ + + +-+ + +-+-+-+ +-+-+ +
| |# # #|#| |# #| |   | |         |   | |
+ + +-+-+ + + +-+-+-+ + +-+-+-+-+-+ + + +
| |# # # #|# #|# # #| |             | | |
+ +-+-+-+-+ +-+ +-+ + +-+-+-+-+-+-+-+ + +
| |# # # #|# # #| |#|         |     | | |
+ + +-+-+ +-+-+-+ + +-+ + +-+ + +-+ + + +
| |#  |# #|# #    |# #| |   | | | | | | |
+ + +-+ +-+ + +-+-+-+ + +-+ +-+ + + + + +
| |#|# #|# #|# # # #|#| |   |     |   | |
+ + + +-+ +-+-+-+-+ + + + +-+ +-+-+-+-+ +
| |#|#|# #| |     |# #| | |   |         |
+ + + + +-+ + +-+ +-+-+-+ + +-+ +-+-+-+ +
|# #|# #|     |# #|       | |   |       |
+ +-+-+-+-+-+-+ + + + +-+-+ + + +-+-+-+ +
|#|    # # # # #|#| |       | | |     | |
+ +-+-+ +-+-+-+-+ + +-+-+ +-+ +-+ +-+ + +
|# #|# #|       |#| |# #|   |   |   | | |
+-+ + +-+ +-+ + + +-+ + +-+-+-+ +-+ + +-+
| |# #|   |   | |#|# #|# # # #| |   |   |
+ +-+-+ +-+ +-+ + + +-+-+-+-+ + + +-+-+ +
|     | | | |   |#|# # #|# #|#| |   |   |
+-+ +-+ + + + +-+ +-+-+ + + + + +-+ + +-+
|   |     | |   |# # # #|#|# #| |   |   |
+ + + +-+-+ +-+ +-+-+-+-+ +-+-+ + +-+-+ +
| | |   |   |     |# # #|# # #|       | |
+ +-+-+ + +-+-+-+-+ +-+ +-+-+ +-+-+-+ + +
|     | |         |# #|#    |#|# # #| | |
+ + +-+ +-+-+-+-+ +-+ + +-+-+ + +-+ +-+ +
| |     | |     |   |#|# # # #|# #|#|   |
+ +-+-+-+ + +-+ + + + +-+-+-+-+-+ + + +-+
|     |   |   |   | |#|  # #|  # #|#|   |
+-+-+ +-+ +-+ +-+-+ + +-+ + + + +-+ +-+ +
|   |   |   | |   | |# #|#|#| |#| |#|# #|
+ +-+-+ + + + + + +-+-+ + + +-+ + + + + +
|         | |   |      # #|# # #|  # #|#|
+-+-+-+-+-+-+-+-+-+-+-+-+-+-+-+-+-+-+-+ +

+ +-+-+-+-+-+-+-+-+-+-+-+-+-+-+-+-+-+-+-+
|0 1 2 3|  5 6|             |   |   |   |
+-+-+-+ +-+ + +-+ +-+ +-+-+ +-+ + + + + +
|     |4|3 4|7 8| |   |   |     | |   | |
+ +-+-+ + +-+-+ + + +-+ + +-+-+-+ +-+-+ +
| |7 6 5|2| |0 9| |   | |         |   | |
+ + +-+-+ + + +-+-+-+ + +-+-+-+-+-+ + + +
| |8 9 0 1|2 1|6 7 8| |             | | |
+ +-+-+-+-+ +-+ +-+ + +-+-+-+-+-+-+-+ + +
| |5 4 3 2|3 4 5| |9|         |     | | |
+ + +-+-+ +-+-+-+ + +-+ + +-+ + +-+ + + +
| |6  |0 1|0 9    |0 1| |   | | | | | | |
+ + +-+ +-+ + +-+-+-+ + +-+ +-+ + + + + +
| |7|8 9|2 1|8 7 6 5|2| |   |     |   | |
+ + + +-+ +-+-+-+-+ + + + +-+ +-+-+-+-+ +
| |8|7|4 3| |     |4 3| | |   |         |
+ + + + +-+ + +-+ +-+-+-+ + +-+ +-+-+-+ +
|0 9|6 5|     |3 4|       | |   |       |
+ +-+-+-+-+-+-+ + + + +-+-+ + + +-+-+-+ +
|1|    8 9 0 1 2|5| |       | | |     | |
+ +-+-+ +-+-+-+-+ + +-+-+ +-+ +-+ +-+ + +
|2 3|6 7|       |6| |8 9|   |   |   | | |
+-+ + +-+ +-+ + + +-+ + +-+-+-+ +-+ + +-+
| |4 5|   |   | |7|6 7|0 1 2 3| |   |   |
+ +-+-+ +-+ +-+ + + +-+-+-+-+ + + +-+-+ +
|     | | | |   |8|5 4 3|8 7|4| |   |   |
+-+ +-+ + + + +-+ +-+-+ + + + + +-+ + +-+
|   |     | |   |9 0 1 2|9|6 5| |   |   |
+ + + +-+-+ +-+ +-+-+-+-+ +-+-+ + +-+-+ +
| | |   |   |     |1 0 9|0 1 2|       | |
+ +-+-+ + +-+-+-+-+ +-+ +-+-+ +-+-+-+ + +
|     | |         |2 3|8    |3|2 3 4| | |
+ + +-+ +-+-+-+-+ +-+ + +-+-+ + +-+ +-+ +
| |     | |     |   |4|7 6 5 4|1 0|5|   |
+ +-+-+-+ + +-+ + + + +-+-+-+-+-+ + + +-+
|     |   |   |   | |5|  1 2|  8 9|6|   |
+-+-+ +-+ +-+ +-+-+ + +-+ + + + +-+ +-+ +
|   |   |   | |   | |6 7|0|3| |7| |7|0 1|
+ +-+-+ + + + + + +-+-+ + + +-+ + + + + +
|         | |   |      8 9|4 5 6|  8 9|2|
+-+-+-+-+-+-+-+-+-+-+-+-+-+-+-+-+-+-+-+ +